111111111111111111111111111111111111111111111111
100000000000000000000000000000000111110011111001
111111111111110000000001111111000000000010000001
100000000000000000001111000000000000000010000001
100000000000000000000000000001000000000000000001
100000011111111110000001111111000000000000000001
100000011111111110000001111111000000000000000001
100000011111111110000001111111000000000000000001
100000000000000000000000000011000000000000000001
100000000001100000000000000000000000000000000001
100000000000011000000000000000000000000000000001
100000000000000110000000000000000000000000000001
100000011111111110000001111111111111111111111111
100000000000000110000000000000000001100000000001
100000000000011000000000000000000001100000000001
100000000001100000000000000000111111100000000001
100000000000011111000000000000110000000000000001
100000000000000001100001111111110000000000000001
100000000000000000000000000000000000000000000001
111111D11111111111111111111111111111111111111111