111111111111111111111111111111111111111
100000000000000000000000000111110001111
111111111111110000000011111110000001001
100000000000000001111000000000000100001
100000000000000000000000100000000000001
100000011111111110001111111000000000001
100000011111111110000111111100000000001
100000011111111110000001111111000000001
100000000000000000000001100000000000001
100000000001100000000000000000000000001
100000000000011000000000000000000000001
100000000000000110000000000000000000001
100000111111111110001111111111111111111
100000000000000110000000000110000000001
100000000000011000000000000110000000001
100000000001100000000011111110000000001
100111110000000000000011000000000000001
100000000000000110000011111111100000001
100000000000000000000000000000000000001
100000000000000000000000000000000000001
1D0000000000000000000000000000000000001
111111111111111111111111111111111111111